S  ####################################################################################################################################################
               #  #        #     #  #  #        #                 #           #        #     #     #  #     #     #        #  #        #              #
####  #######  #  #######  ####  #  #  ####  ##########  #  ####  ####  #  #######  ####  ####  ####  ####  ####  ####  #  #  ####  #######  #  #######
#     #              #     #     #        #  #  #        #  #  #        #  #        #     #  #              #           #        #  #        #  #     #
#  #  #######  ##########  ####  #######  #  #  #  ####  #  #  #  #######  ####  ####  #  #  #  #########################  ####  #  ##########  #  ####
#  #  #        #  #     #  #  #                 #  #     #  #  #  #     #              #        #     #        #        #  #        #              #  #
#  ####  ####  #  #  #  #  #  #  #  #  #  #######  #######  #  #  #  ################  #  ##########  #  ####  #  #############  ####  #  #######  #  #
#     #  #        #  #  #        #  #  #           #  #  #  #  #  #        #  #  #  #  #  #     #     #  #           #  #  #     #     #        #     #
#  #  #######  ####  ####  ####  #  #  #############  #  ####  #  #  #######  #  #  #  #######  #  ##########  #######  #  ####  #  #  #######  #  #  #
#  #  #     #        #        #  #  #  #     #     #     #     #  #           #     #  #  #        #           #  #              #  #  #  #     #  #  #
#  #  #  #  #######  #  ####  #  #######  #######  #  #  #  #  #  #######  ####  #  ####  #  #######  ##########  #  #  #  #############  #  ####  ####
#  #  #  #  #           #     #     #        #  #     #     #                    #        #           #              #  #  #  #     #        #  #  #  #
##########  ####  #######  ##########  ####  #  #  ####  ##########  #  ####  ######################  ####  ##########  ####  ####  ####  ####  #  #  #
#     #           #  #  #  #     #     #  #  #  #  #  #        #     #  #     #        #              #     #        #                    #  #  #  #  #
#  #  ####  #  ####  #  ####  #  ####  #  #  #  #  #  ######################  #  #  #######  #  #############  ####  ####  #  #  #  #  #  #  #  #  #  #
#  #        #        #  #  #  #  #     #        #  #  #  #        #           #  #  #     #  #              #     #        #  #  #  #  #  #     #     #
####  ##########  #  #  #  ####  #  #  #############  #  ####  #############  #  #  #  ##########  #  #  ####  #  #######  ##########  ####  #  ####  #
#     #  #     #  #        #        #        #     #  #        #     #     #     #        #        #  #     #  #  #        #                 #     #  #
#######  #  #  ####  #  #######  #  #  ####  ####  #  #######  #  ####  #  ####  #######  #######  #  #  ##########  ####  ##########  #######  #######
#  #        #  #     #           #  #  #     #        #              #  #     #     #           #  #  #     #  #     #     #     #     #  #     #  #  #
#  ##########  ##########  ##########  #######  #  ####  #######  ##########  #  #  #############  #  ####  #  ####  #######  #  #  ####  #  ####  #  #
#  #  #  #  #     #     #     #  #           #  #  #     #     #              #  #     #     #     #  #  #  #        #  #     #  #  #                 #
#  #  #  #  #  #  #  ##########  ####  #  ####  ####  #  #  ################  #######  ####  ####  ####  #############  #  #######  #  #  ##########  #
#              #        #        #     #     #     #  #           #  #     #                    #              #     #           #  #  #     #  #  #  #
#######  #  ################  #  ##########  #  ##########  #######  ####  ##########  ####  ####  #  ####  #######  #######  #######  ####  #  #  ####
#  #  #  #  #                 #        #     #     #  #     #     #        #  #           #  #  #  #     #  #     #     #           #  #  #        #  #
#  #  ####  #  ####  ##########  #############  #  #  ##########  #  #  #  #  #  ##########  #  #  ##########  #  #  ####  #######  ####  #  #######  #
#           #  #        #                 #     #  #     #           #  #                 #  #  #              #  #           #                    #  #
#  ####  ################  ####  #############  #  #  #######  ##########  #  #############  #  ##########  #  ##########  ################  #######  #
#     #                 #  #     #        #  #  #           #     #  #  #  #        #     #           #     #     #        #  #  #           #  #     #
#  ####  ####  ##########  ####  #  #  ####  #  ##########  #  ####  #  #  ####  ####  #######  #######  #  ####  ####  ####  #  ####  ####  #  #  ####
#  #  #     #     #  #     #  #     #     #  #     #     #  #     #        #  #     #           #  #     #     #                    #  #        #  #  #
#  #  #######  ####  #  #  #  #  ####  #  #  #  ####  ##########  ####  #  #  #######  #  #  #  #  #  ####  #  #############  #  #  #######  ####  #  #
#  #        #  #        #  #  #  #     #  #     #     #  #        #  #  #  #  #        #  #  #  #  #  #     #        #  #     #  #     #              #
####  #######  ##########  #  #  #############  ####  #  ##########  #  ####  ##########  #  #  #  ####  #############  ################  #############
#     #     #     #     #  #           #  #        #     #  #        #     #  #  #  #  #  #  #     #     #  #              #     #     #     #  #     #
#  ####  #######  ####  #  #  ####  ####  ####  #######  #  #  ####  ####  #  #  #  #  #  #######  #  #  #  #  #######  ####  ####  ####  ####  #  ####
#                          #     #  #  #           #  #  #  #  #        #  #     #        #           #     #  #        #        #  #              #  #
#  ####  #  #  ##########  #######  #  #  #  #  ####  #  #  #  ####  #######  #  #############  #  ####  #  #  #######  #  ####  #  ####  #######  #  #
#  #     #  #  #              #           #  #        #           #     #  #  #              #  #  #  #  #  #  #  #  #  #  #     #        #  #        #
####  ##########  ####  #######  ####  ####  ####  #  ####  ####  #  ####  #############  #  #  #  #  #  ####  #  #  ####  ####  ####  #  #  #  ####  #
#        #     #     #  #        #  #  #        #  #        #     #  #        #        #  #     #  #     #  #           #     #  #     #  #        #  #
#  ####  ####  #  ####  #  ####  #  ##########  #  #  #############  #  #############  ####  #######  #  #  #  #  ####  ####  #  ##########  #  ####  #
#  #  #        #  #     #     #        #        #  #  #                 #     #        #  #        #  #  #  #  #  #     #  #  #     #  #     #  #     #
####  #  #  ####  #  #######  ################  #######  ####  #  ####  #  ##########  #  ####  #######  #  #  ####  ####  #  #  ####  #  ####  #  ####
#     #  #  #  #  #        #        #        #  #  #     #     #     #           #  #           #  #     #        #           #        #  #     #  #  #
#  #  ####  #  #  #############  ####  #######  #  #  ####  ##########  ####  ####  ##########  #  ##########  #############  #  ################  #  #
#  #           #           #     #     #  #     #  #     #  #        #  #     #  #     #  #           #     #           #     #  #  #     #  #  #  #  #
#  ##########  ################  ####  #  ####  #  #######  ####  ##########  #  ####  #  #  #######  #  #  #######  ####  #  ####  #  ####  #  #  #  #
#     #        #           #        #     #  #  #                 #              #  #  #  #     #  #  #  #           #     #                 #        #
#  #  ####  #  #  #######  #######  ####  #  #  ####  #############  #  #  ####  #  #  #  #######  #  ####  ##########  ####  #  ####  ####  #######  #
#  #     #  #  #  #  #        #  #  #  #        #  #  #  #           #  #     #        #  #        #     #     #     #  #     #  #  #     #     #     #
#######  #######  #  ####  ####  #  #  ##########  #  #  #  #  ####  ####  #  #  ####  #  ####  ####  ##########  ################  ####  #######  #  #
#        #     #  #        #  #  #  #        #           #  #  #     #     #  #     #  #     #        #        #     #     #  #        #  #     #  #  #
####  ####  ####  #######  #  #  #  #  ####  ###################  #  ##########  #  #######  ####  ####  ####  ####  #  #  #  ####  ####  ####  #  #  #
#           #  #     #  #        #     #           #              #     #        #  #     #              #  #     #     #     #  #  #        #     #  #
#  ####  ####  #  ####  ####  ####  #  ####  ##########  ################  #######  #  #  #  #  ##########  #  #############  #  #  #  #  #  #  #  ####
#  #        #        #  #     #     #     #        #  #           #              #  #  #     #  #        #        #     #           #  #  #  #  #     #
####  #  #  #  #######  ####  ####  #  ####  ####  #  ####  ####  ####  ####  #  #######  ####  #######  #  #  ####  #############  #  ####  #  #  ####
#     #  #  #  #        #           #  #     #  #        #     #  #  #  #     #     #     #  #  #           #     #     #              #     #  #  #  #
####  ####  ##########  #############  #  ####  #############  ####  #  #######  #######  #  #  #  #  #######  ####  #############  #######  ####  #  #
#     #  #  #        #        #     #  #           #     #     #              #  #     #  #     #  #     #  #              #  #     #           #     #
#  ####  ####  #  #######  ####  ######################  ####  ###################  #############  #######  #######  #######  #  #  #######  ##########
#  #        #  #        #        #  #              #  #  #  #           #  #  #  #           #  #        #     #        #  #  #  #  #        #  #  #  #
#######  ####  #######  #  #  ####  #######  #  ####  #  #  ####  ####  #  #  #  ####  #######  #  ####  #  #######  #  #  #  #  ##########  #  #  #  #
#                 #        #     #        #  #           #           #           #        #     #  #        #     #  #     #  #     #  #  #     #     #
####  #  #  #######  ####  #  #  #  #  ##########  ####  #  ####  #############  #  #######  #######  #######  #  #######  #  #  ####  #  ####  #  ####
#     #  #  #           #  #  #     #     #  #     #           #  #  #     #                 #  #        #     #  #  #           #  #                 #
####  #############  ##########  ####  #  #  #  #  #  #  #  ####  #  ####  #  ################  ##########  #  ####  #######  #  #  ###################
#     #     #        #  #     #  #     #     #  #  #  #  #  #  #     #  #  #        #     #     #  #        #  #           #  #     #  #        #     #
####  #  #  ####  ####  ####  #  ####  #  #  #  ####  #######  #  #  #  #  #  #  ####  #######  #  #  ####  #######  ####  #  #  #  #  #  #  ####  ####
#  #     #  #  #     #        #     #  #  #  #  #  #           #  #  #  #     #        #     #        #        #  #     #     #  #     #  #     #     #
#  #  #######  #  #  #######  ####  #  #  ####  #  ####  #############  #  ##########  #  ####  #  #  #######  #  #  #  #######  #  #######  #  #  ####
#        #     #  #  #     #     #  #  #     #     #  #  #           #  #     #  #     #  #  #  #  #  #  #     #  #  #     #  #  #           #        #
#######  ####  #######  #  ####  ####  ####  ####  #  ####  #  #######  #######  ####  #  #  #  #######  #  #  #  #  ####  #  #  #  #  #  #  #  #  #  #
#        #     #  #  #  #        #        #  #     #     #  #                    #        #     #     #  #  #     #  #  #  #  #  #  #  #  #  #  #  #  #
####  #  #  ####  #  ####  ####  #  #######  #  ####  ##########  ####  ####  #  ####  ####  #######  #  #######  #  #  ####  #  #######  ####  ####  #
#     #        #        #  #  #     #  #     #     #     #           #  #     #  #        #  #  #                       #  #     #        #     #     #
#  ##########  ####  #######  #  ####  ####  ####  ####  #  ####  ####  ####  #######  #######  #######  #  #  #######  #  #  #  #  ####  ##########  #
#        #              #  #        #     #        #  #  #     #     #  #                    #        #  #  #  #     #  #  #  #  #     #        #  #  #
#######  #  ####  #  ####  #  ##########  #  #  ####  #  ####  ####  ####  #  #  #  #  #  ####  ##########  #  ####  ####  ####  #  ##########  #  ####
#     #  #  #     #  #     #  #        #  #  #  #        #  #  #  #  #     #  #  #  #  #  #     #           #        #           #  #  #           #  #
####  ####  #######  #  #  ####  ####  #  #  #######  ####  ####  #######  #  #  #  #######  #######  ####  ####  #  ####  ##########  #######  ####  #
#     #  #  #           #  #     #  #           #  #     #        #     #  #  #  #        #  #     #  #  #     #  #  #        #        #              #
#  ####  #  #  ###################  ####  #######  ####  #  #######  #######  #############  ####  #  #  #  ####  ####  #######  ######################
#        #  #     #     #  #     #     #  #  #  #  #  #  #     #                    #  #  #     #     #     #        #  #     #        #        #     #
#  #######  #######  ####  #  ####  ####  #  #  #  #  #  #  #  #  #######  #######  #  #  ####  #  #############  #######  #######  ####  #  ####  ####
#        #        #     #                                   #  #  #        #                 #        #              #              #     #  #        #
#######  #  ####  #  #  ##########  ####  #  ####  ##########  #######  ####  #  #############  #  #######  #  #  #  #  #  #######  ####  #  #  #  ####
#  #  #  #  #  #  #  #     #     #  #  #  #     #     #        #  #        #  #              #  #        #  #  #  #  #  #  #           #  #     #     #
#  #  #  #  #  #  ####  #######  #  #  #  ######################  #  ###################  #  ####  #  ##########  ###################  ####  ####  ####
#  #        #  #           #           #     #                    #     #                 #     #  #  #  #  #  #  #              #        #  #  #  #  #
#  #  #  #  #  ####  #######  ###################  ####  ###################  ################  ####  #  #  #  #  #######  #######  ####  ####  #  #  #
#     #  #        #        #  #  #        #           #     #  #        #  #        #        #  #        #     #  #        #     #  #  #  #     #  #  #
#  ####  #  ##########  #######  #  #  ####  #######  ####  #  #  #  ####  ####  ####  #  ####  ####  #  #  #  #######  #  #  ####  #  #  #  #  #  #  #
#     #  #  #  #  #     #           #  #  #  #  #  #     #        #     #     #  #     #        #  #  #  #  #        #  #     #     #        #  #     #
#  #  ####  #  #  ################  ####  #  #  #  #############  ####  ####  ####  ####  ####  #  ####  #  ################  #  #######  #  ####  #  #
#  #  #                 #  #  #  #     #  #  #              #        #           #  #  #     #  #  #           #     #     #        #  #  #        #  #
#######  #  #  #######  #  #  #  #  ####  #  #######  ####  ####  #  #  #  #  ####  #  #  ####  #  #######  ####  #######  ####  #  #  #  ##########  #
#        #  #        #     #                       #  #           #  #  #  #        #        #                                   #     #           #   
####################################################################################################################################################  E