S  ##########################################################
   #     #     #  #  #  #  #     #        #                 #
#  #  #  ####  #  #  #  #  ####  #  #  #######  #######  ####
#     #  #                       #  #  #        #     #  #  #
####  ###################  #  #  ####  #  #  ####  #  ####  #
#        #  #        #  #  #  #  #  #  #  #     #  #  #     #
#  #######  ####  ####  #  ####  #  #  ####  ####  #  #  #  #
#     #  #              #     #              #     #     #  #
#  ####  #  #######  #  #######  ####  ####  #  #############
#     #  #  #        #     #     #     #           #        #
#  #  #  ####  ################  ####  #######  ####  ####  #
#  #        #        #     #     #  #  #  #        #  #     #
#  #######  #  #  #  #  #  #  ####  #  #  #######  #######  #
#        #     #  #     #     #        #     #  #        #  #
#  ##########  ####  ####  ####  #######  ####  #  #######  #
#     #           #     #  #  #        #                 #  #
#  ################  #######  ######################  #  #  #
#        #           #     #  #     #  #              #     #
#  ####  #  #  #  #######  #  #  ####  ####  ##########  ####
#     #  #  #  #  #        #     #  #           #           #
#######  #############  #  #  ####  ####  #  ####  #######  #
#        #  #           #  #     #     #  #     #     #  #  #
#######  #  ####  #######  #  ####  ####  #  #  ####  #  ####
#        #     #  #        #              #  #  #  #  #  #  #
#  ##########  #  #######  #  ####  ####  ####  #  ####  #  #
#     #        #        #        #     #  #           #     #
#  #######  #  #  #######  #  #  #  #  #######  ##########  #
#  #  #     #  #     #     #  #  #  #        #        #     #
####  #  ####  ####  ##########  #  #  ####  ####  #  #  ####
#        #  #     #  #        #  #  #     #  #  #  #        #
#  #######  #############  #  #  #############  #  #######  #
#        #     #  #        #        #     #     #  #  #     #
#######  ####  #  ####  #  #######  ####  #  ####  #  ####  #
#  #  #     #  #  #     #  #        #     #           #     #
#  #  #  ####  #  #  #######  #######  #  ##########  ####  #
#                 #        #  #     #  #  #        #     #  #
#  #######  #######  #  #  ####  #######  ####  #  #  ####  #
#  #  #  #        #  #  #     #        #        #  #  #  #  #
#  #  #  #  ##########  ####  #  #  ####  #  #######  #  ####
#     #                    #  #  #        #                  
##########################################################  E